0|3|8|6|7|5
3|0|0|0|0|0
8|0|0|0|0|0
6|0|0|0|0|0
7|0|0|0|0|0
5|0|0|0|0|0
